20 20
0 1 1 1 1 1 1 1 1 1 1 1 1 1 1 1 1 1 1 2
5 19 14 13 14 9 14 28 28 14 9 13 14 13 13 21 13 30 28 7
5 14 14 13 13 9 14 14 14 14 9 13 13 13 14 13 14 13 13 7
5 13 13 13 13 9 14 14 14 14 9 16 16 6 6 8 6 6 9 7
5 13 13 13 13 6 8 16 16 8 6 13 13 8 13 14 13 28 13 7
5 13 13 14 13 13 13 13 13 13 13 13 13 9 13 13 14 21 13 7
5 13 13 13 13 13 13 21 13 13 13 14 13 6 14 13 13 13 13 7
5 13 14 13 13 14 13 13 14 28 13 13 13 8 13 13 13 14 13 7
5 13 13 14 13 13 13 13 13 13 14 13 14 13 14 13 14 13 13 7
5 8 8 8 8 13 13 13 13 14 13 13 13 13 13 13 13 13 13 7
5 13 13 13 13 13 13 13 13 13 13 14 13 13 14 13 13 13 13 7
5 13 13 13 14 13 13 13 14 13 13 13 13 13 21 13 13 13 28 7
5 13 28 13 13 6 13 13 13 13 13 13 13 13 14 13 13 13 13 7
5 13 14 13 13 9 13 14 13 13 13 13 14 6 15 6 6 9 6 7
5 13 13 13 13 6 13 13 13 13 13 13 13 6 14 13 13 28 13 7
5 13 13 13 13 6 13 13 13 14 13 13 14 6 21 13 13 13 13 7
5 13 14 13 21 8 14 21 13 13 13 14 13 8 13 13 13 13 22 7
5 13 14 14 13 6 13 13 13 13 28 13 13 6 13 13 13 13 14 15
5 30 13 13 14 6 13 13 14 13 13 13 13 8 28 13 22 13 13 7
10 11 11 11 11 11 11 11 11 11 11 11 11 11 11 11 11 11 11 12