20 20
0 1 1 1 1 1 1 1 1 1 1 1 1 1 1 1 1 1 1 2
5 13 13 13 13 13 13 13 13 13 13 13 13 13 13 13 13 13 13 7
5 13 13 13 13 13 13 13 13 13 13 13 13 13 13 13 13 13 13 7
5 13 13 6 6 13 13 13 8 8 13 8 13 13 13 6 6 13 13 7
5 13 13 6 6 13 13 13 9 13 13 9 13 13 13 6 6 13 13 7
5 13 13 13 13 13 13 13 9 13 13 9 13 13 13 13 13 13 13 7
5 13 13 13 13 13 13 13 9 13 13 9 13 13 13 13 13 13 13 7
5 13 13 6 6 13 13 13 9 13 13 9 13 13 13 6 6 13 13 7
5 13 13 6 6 13 13 13 9 13 13 9 13 13 13 6 6 13 13 7
5 13 13 13 13 13 13 13 9 13 13 9 13 13 13 13 13 13 13 7
5 13 13 13 13 13 13 13 9 13 13 9 13 13 13 13 13 13 13 7
5 13 13 6 6 13 13 13 9 13 13 9 13 13 13 6 6 13 13 7
5 13 13 6 6 13 13 13 9 13 13 9 13 13 13 6 6 13 13 7
5 13 13 13 13 13 13 9 9 13 13 9 9 13 13 13 13 13 13 7
5 13 13 13 13 13 13 9 13 13 13 13 9 13 13 13 13 13 13 7
5 13 13 13 13 13 9 9 13 13 13 13 9 9 13 13 13 13 13 7
5 13 13 13 13 9 9 13 13 13 13 13 13 9 9 13 13 13 13 7
5 13 13 13 13 9 13 13 13 13 13 13 13 13 9 13 13 13 13 7
5 13 13 13 13 9 13 13 13 13 13 13 13 13 9 13 13 13 13 7
10 11 11 11 11 11 11 11 11 15 11 11 11 11 11 11 11 11 11 12
hacker 1 1
bug 5 6
portaTrancada 10 3 chave 3 1
