20 20
0 1 1 1 1 1 1 1 1 1 1 1 1 1 1 1 1 1 1 2
5 19 21 13 13 13 13 13 13 13 13 13 13 13 13 13 13 13 13 7
5 13 13 13 13 13 13 13 13 13 13 13 13 13 13 13 13 13 13 7
5 13 13 6 6 13 13 13 8 8 15 8 13 13 13 6 6 13 13 7
5 13 13 6 6 13 13 13 9 13 13 9 13 13 13 6 6 13 21 7
5 13 13 13 13 13 13 13 9 13 13 9 13 13 13 13 13 13 13 7
5 13 13 13 13 13 13 13 9 22 13 9 13 13 13 13 13 13 13 7
5 13 13 6 6 13 13 13 9 13 13 9 13 13 13 6 6 28 13 7
5 13 28 6 6 13 13 13 9 13 13 9 13 13 13 6 6 13 13 7
5 13 13 13 13 13 13 13 9 13 13 9 13 13 13 13 13 13 13 7
5 13 13 13 13 13 21 13 9 13 13 9 28 13 13 13 13 13 13 7
5 13 13 6 6 13 13 13 9 13 22 9 13 13 13 6 6 13 13 7
5 13 13 6 6 13 13 13 9 13 13 9 13 13 13 6 6 13 13 7
5 13 13 13 13 13 13 9 9 13 13 9 9 13 13 13 13 13 13 7
5 13 13 13 13 13 13 9 28 13 13 28 9 13 13 13 13 13 13 7
5 13 21 13 13 13 9 9 13 13 13 13 9 9 13 13 13 21 13 7
5 13 13 13 13 9 9 13 13 13 13 13 13 9 9 13 13 13 13 7
5 13 13 13 13 9 13 13 13 13 13 13 13 13 9 13 13 13 13 7
5 13 13 13 28 9 13 13 13 13 22 13 13 13 9 13 13 13 30 7
10 11 11 11 11 11 11 11 11 15 11 11 11 11 11 11 11 11 11 12