20 20
6 6 6 6 6 6 6 6 6 6 6 6 6 6 6 6 6 6 6 6
6 19 6 13 13 13 6 13 6 13 13 13 6 13 13 13 13 13 13 6
6 13 6 6 6 13 6 13 6 13 6 13 6 13 6 13 6 13 6 6
6 13 13 13 13 13 13 13 13 13 6 13 6 13 13 13 13 13 13 6
6 13 6 6 6 13 6 13 6 6 6 13 6 13 6 6 6 13 6 6
6 13 13 13 13 13 6 13 6 13 13 13 6 13 6 13 13 13 13 6
6 6 6 13 6 6 6 13 6 13 6 13 6 13 6 6 6 6 6 6
6 13 13 13 6 13 13 13 13 13 6 13 6 13 13 13 13 13 13 6
6 6 6 13 6 13 6 6 6 6 6 6 6 6 6 13 6 6 6 6
6 13 13 13 13 13 13 13 6 13 13 13 13 13 6 13 13 13 13 6
6 13 6 13 6 13 6 6 6 6 6 13 6 6 6 6 6 6 6 6
6 13 6 13 6 13 13 13 6 13 6 13 13 13 6 13 6 13 13 6
6 6 6 6 6 13 6 6 6 13 6 6 6 13 6 13 6 13 6 6
6 13 6 13 13 13 6 13 13 13 13 13 13 13 13 13 6 13 6 6
6 13 6 6 6 13 6 6 6 6 6 13 6 6 6 6 6 6 6 6
6 13 13 13 6 13 13 13 6 13 6 13 13 13 6 13 13 13 6 6
6 6 6 13 6 13 6 13 6 13 6 13 6 13 6 13 6 6 6 6
6 13 13 13 13 13 6 13 6 13 13 13 6 13 13 13 6 13 13 6
6 13 6 13 6 6 6 6 6 13 6 13 6 13 6 6 6 6 6 6
6 6 6 6 6 6 6 6 6 6 6 6 6 6 6 6 6 6 6 6